[
  [63,18,18,60,18,18,18,18,63,60,18,18,63,60,18,18,18,18,18,18],
  [18,1,18,62,18,18,18,18,60,18,18,18,18,18,18,18,18,18,1,18],
  [18,18,39,63,18,18,18,18,0,18,18,18,18,18,18,18,18,18,18,18],
  [18,18,39,39,18,18,18,18,18,18,18,18,18,18,18,18,18,39,18,18],
  [18,18,18,18,18,18,63,18,18,18,18,18,18,39,39,18,39,18,18,18],
  [18,18,18,18,39,18,18,18,18,18,18,18,18,18,18,18,18,18,18,18],
  [62,18,18,18,39,18,39,18,0,0,0,0,18,18,39,18,18,18,18,60],
  [18,18,18,18,18,18,18,18,0,100,39,0,39,18,18,18,18,18,18,61],
  [18,18,18,39,18,39,18,39,0,0,0,0,39,18,18,18,18,18,18,18],
  [18,18,18,39,18,18,18,18,18,18,18,18,18,18,18,18,60,18,18,18],
  [18,18,18,18,39,18,18,18,18,18,18,39,18,39,18,39,0,61,18,18],
  [18,18,18,18,39,18,18,18,18,18,39,18,18,18,18,18,18,39,18,60],
  [18,18,39,18,18,18,18,18,18,18,18,18,18,18,18,18,18,18,18,18],
  [18,1,18,18,18,18,18,18,18,18,18,18,18,18,18,18,18,39,1,18],
  [18,18,18,18,18,18,18,18,18,62,61,18,18,18,18,18,18,62,18,61]
]