[
  [100,18,18,18,18,18,18,18,18,60,18,18,18,18,18,18,63,60,18,18],
  [18,39,39,18,39,18,18,18,18,0,18,18,18,18,18,18,18,18,18,60],
  [18,18,39,18,18,18,39,18,18,60,18,39,18,39,18,18,18,18,18,61],
  [18,18,18,18,39,61,18,39,18,0,18,18,28,39,18,18,18,39,18,18],
  [18,18,18,39,18,18,18,18,39,0,18,18,28,39,18,39,18,18,18,18],
  [18,18,18,18,18,18,18,18,18,18,18,18,18,18,18,18,18,18,18,18],
  [18,18,18,39,18,18,18,18,18,18,18,18,18,18,18,18,29,18,18,18],
  [18,18,18,18,18,18,18,18,18,61,62,39,18,39,18,18,18,18,18,18],
  [18,18,18,18,63,18,18,18,18,60,63,39,18,18,39,39,18,18,18,18],
  [18,18,18,18,62,18,18,18,18,18,18,18,18,18,61,18,39,39,39,18],
  [62,61,18,18,18,18,18,18,39,39,18,18,18,18,18,18,18,18,18,39],
  [18,18,18,39,18,39,18,39,18,18,39,18,18,18,18,18,18,18,39,18],
  [18,18,18,39,18,39,18,63,18,18,18,39,18,18,39,61,39,18,18,18],
  [18,39,18,39,52,39,18,62,18,18,18,18,18,18,18,18,18,18,18,61],
  [1,18,18,18,18,39,18,18,18,18,18,18,62,61,62,61,18,18,18,18]
]