[
  [1,0,0,0,0,0,0,0,0,0],
  [0,2,5,5,5,5,5,5,5,0],
  [0,2,0,0,0,0,0,0,4,0],
  [0,2,0,0,0,0,0,0,4,0],
  [0,2,0,0,39,0,0,0,4,0],
  [0,2,0,0,0,100,0,0,4,0],
  [0,2,0,0,0,0,0,0,4,0],
  [0,2,0,0,0,0,0,0,4,0],
  [0,3,3,3,3,3,3,3,4,0],
  [0,0,0,0,0,0,0,0,0,0]
]