[
  [0,0,0,0,0,0,0,0,0,0,0,0,0,0,0,0,0,0,0,0],
  [0,0,0,0,0,18,18,18,18,18,0,0,0,0,0,0,0,0,0,0],
  [0,0,0,18,18,18,18,18,18,18,18,18,0,0,0,0,0,0,0,0],
  [0,0,18,18,18,18,18,18,1,18,18,18,18,0,0,0,0,0,0,0],
  [0,0,18,18,18,18,18,18,18,18,18,18,18,0,0,0,0,0,0,0],
  [0,18,18,18,18,18,18,18,18,18,18,0,0,0,0,0,0,0,0,0],
  [0,18,18,18,18,18,18,18,18,0,0,0,0,0,0,0,0,0,0,0],
  [0,18,18,18,18,18,18,0,0,0,39,0,0,0,39,0,0,0,39,0],
  [0,18,18,18,18,18,18,18,18,0,0,0,0,0,0,0,0,0,0,0],
  [0,18,18,18,18,18,18,18,18,18,18,0,0,0,0,0,0,0,0,0],
  [0,0,18,18,18,18,18,18,18,18,18,18,18,0,0,0,0,0,0,0],
  [0,0,18,18,18,18,18,18,18,18,18,18,18,0,0,0,0,0,0,0],
  [0,0,0,0,18,18,18,18,18,18,18,18,0,0,0,0,0,0,0,0],
  [0,0,0,0,0,18,18,18,18,18,0,0,0,0,0,0,0,0,0,0],
  [0,0,0,0,0,0,0,0,0,0,0,0,0,0,0,0,0,0,0,100]
]