[
  [0,0,0,0,0,0,0,0,0,0],
  [20,21,22,23,24,25,26,27,20,21],
  [0,0,0,0,0,0,0,0,0,0],
  [0,0,0,0,0,100,0,0,0,0],
  [0,0,0,0,0,0,0,0,0,0],
  [30,31,32,33,34,35,36,37,30,32],
  [0,0,0,0,0,0,0,0,0,0],
  [0,0,0,0,0,0,0,0,0,0],
  [0,0,0,0,1,0,0,0,0,0],
  [0,0,0,0,0,0,0,0,0,0]
]