[
  [100,0,0,29,0,0,29,29,29,29,29,29,29,29,63,0,1,0,60,29],
  [0,0,39,29,39,0,28,28,28,28,28,0,60,29,0,39,60,63,0,60],
  [0,0,0,0,0,0,29,29,0,0,29,0,0,29,18,29,62,39,28,28],
  [29,39,29,29,29,0,0,29,39,0,28,60,0,29,18,29,0,0,39,0],
  [0,0,0,0,0,0,0,0,0,0,29,28,28,29,18,29,0,39,29,0],
  [0,39,0,28,29,63,28,60,29,29,29,28,28,29,18,29,0,0,0,0],
  [28,18,29,0,29,28,29,39,29,29,29,28,28,29,39,18,18,0,0,0],
  [28,18,29,0,29,0,0,18,63,28,39,0,0,29,28,29,39,29,29,0],
  [28,18,29,38,29,0,29,18,0,39,28,0,0,61,60,60,62,0,28,0],
  [28,18,29,0,29,0,29,29,0,0,0,0,29,29,28,28,29,29,29,0],
  [28,18,29,0,29,0,0,29,0,0,0,0,18,0,0,0,18,0,29,0],
  [28,18,39,61,0,18,39,60,29,29,29,28,29,29,28,29,39,0,0,18],
  [28,0,0,0,29,0,0,0,0,0,0,28,28,28,28,0,61,38,29,39],
  [28,29,29,62,28,28,28,61,29,29,29,28,29,29,28,29,0,0,29,0],
  [62,62,0,0,0,0,0,0,62,0,0,0,0,0,61,29,62,28,28,61]
]