[
  [29,29,29,29,29,29,29,29,29,29,29,29,29,29,29,70,29,29,29,29,29,29,29,29,29],
  [29,0,0,0,0,0,29,29,0,0,0,29,29,0,0,28,0,0,29,0,0,0,0,0,29],
  [29,0,100,0,0,0,29,71,0,50,0,73,29,0,39,3,3,0,29,0,80,81,0,0,29],
  [29,0,0,0,0,0,29,0,0,18,0,0,0,0,0,28,0,0,18,0,0,0,0,0,29],
  [29,0,0,0,0,0,29,0,0,41,29,29,29,0,5,5,5,0,29,0,0,0,0,83,29],
  [29,0,0,0,0,0,29,0,0,0,29,29,29,0,3,3,3,0,29,0,0,82,0,0,29],
  [29,29,29,38,29,29,29,29,29,0,29,29,29,29,29,29,29,29,29,29,29,0,29,29,29],
  [29,0,0,0,0,0,29,43,40,0,0,0,29,8,0,9,9,9,29,9,9,9,9,9,29],
  [29,0,39,0,0,0,29,63,0,0,0,0,29,9,39,0,9,9,29,9,9,0,9,9,29],
  [29,0,0,0,0,0,29,0,0,0,0,73,29,9,9,9,9,9,0,9,9,9,0,9,29],
  [29,18,18,18,18,18,29,0,0,0,0,0,29,9,8,8,9,9,29,0,9,9,9,72,29],
  [29,0,0,0,0,0,29,0,0,0,0,0,29,9,9,0,9,9,29,9,9,9,9,73,29],
  [29,29,29,0,29,29,29,29,29,0,29,29,29,29,29,18,29,29,29,29,29,29,29,29,29],
  [29,0,0,0,29,29,29,43,0,0,0,73,29,18,18,39,18,18,29,43,0,0,0,40,29],
  [29,0,29,29,29,29,29,0,0,0,0,0,29,18,39,18,39,18,29,0,14,0,17,83,29],
  [29,0,0,0,0,0,29,0,0,0,0,0,29,18,18,50,39,18,0,0,0,82,0,0,29],
  [29,28,28,28,28,0,29,0,0,0,0,0,29,18,39,18,18,18,29,18,18,18,18,18,29],
  [29,28,28,39,0,0,29,0,0,0,0,0,29,42,62,25,18,41,29,71,0,12,0,41,29],
  [29,29,29,18,29,29,29,29,29,0,29,29,29,29,29,29,29,29,29,29,28,28,28,29,29],
  [29,43,0,0,29,29,29,29,29,0,18,18,29,17,0,38,0,73,29,9,9,2,9,5,29],
  [29,28,0,29,29,29,29,29,29,29,39,0,29,29,29,43,28,40,29,9,39,9,9,4,29],
  [29,28,0,0,0,18,0,0,18,39,49,0,29,14,0,39,41,0,35,0,9,18,1,4,29],
  [29,28,29,29,29,39,29,0,18,0,0,0,29,29,29,29,0,0,28,9,3,9,9,4,29],
  [29,42,28,28,28,41,29,42,18,0,41,29,29,12,0,0,0,72,29,3,4,9,9,9,29],
  [29,29,29,29,29,29,29,29,29,29,29,29,29,29,29,29,29,29,29,29,29,29,29,29,29]
]